####################
#&&&&&&&&&&&&&&&&&&#
####################
####################
#  A   A   A   A   #
# ### # ### # ###  #
#A# #A#     #A# #A #
# ### # # # # ###  #
#     #A# #A#      #
# ##### # # #####  #
#A# A         A #A #
# # #####A##### #  #
#   A         A    #
# ##### ### #####  #
#  A    # #    A   #
# ### # ### # ###  #
# # # #     # # #  #
# ### # ### # ###  #
#A    # # # #    A #
# ##### ### #####  #
#     0XXX         #
####################
